#########################
#S#.......#.............#
#.#.#.###.#######.####..#
#.#.#.#.........#.#.....#
#...#.#########.#.###.#.#
#.#.#...#...#...#...#...#
#.#####.#.###.###.#.##..#
#.......#.........#.#...#
#.#.#####.#####.###.#.###
#...#.....#...#...#.....#
#####.#####.#.#######.#.#
#.#...#.....#...........#
#.#.####.#..######.####.#
#...........#..........E#
#########################
